18-7
.S....CTTT........
..S....TTT..C....O
....T..T.....O....
................CC
@.S....T........CC
.......TTT......CC
.................C